11111011111000111100
00100010000000100000
00100010000000110000
00100011100000011000
00100010000000001100
00100010000000001100
00000011111100111000
00011111111111111100
00000000010000000000
00000000010000000000